W W W W W W W W W W W W W W W
W R R R R E R W R R R R R R W
W R P R O R R W R R W M W M W
W R R R R R R W R W W R W R W
W R R R R R R W R R W R R R W
W R M R M R R W R R W R R R W
W R R R R R R W R R W R R G W
W R R R R R R W R R W W W W W
W R W W W W W W R W R R R O W
W R R W R R R W R W R W R W W
W W R W R W R R R R R W R W W
W R R W R R R R R R R W R W W 
W W R R R R R M R R R R W W W
W E R W W W R R W R W R R O W
W W W W W W W W W W W W W W W 